【CAD迷你画图】常用快捷键命令


1.工具栏命令

平移		P		【P、PAN】
打印		PRINT		【PR、PRI、PRIN、PRINT、PLOT】

【绘图命令】
直线		L		【L、LINE】
多段线		PL		【PL、PLINE】
双线		DBL 
圆弧		ARC		【A、ARC】
圆形		C		【C、CIRCLE】
矩形		REC		【REC、RECTANGLE】
圆角矩形		RREC	
椭圆		EL		【EL、ELLIPSE】
正多边形		POL		【POL、POLYGON】
样条曲线		SPL		【SP、SPL、SPLINE】

【编辑命令】   	
图形延伸		EX		【EX、EXTEND】
图形修剪		TR		【TR、TRIM】
倒圆角		F		【F、FILLET】
倒直角		DZJ/CHA		【CHAMFER】
倒斜角		DXJ
填充		H		【H、BHATCH】
拉伸		S		【STRETCH】

【标注命令】
尺寸标注		DLI		【DL、DLI、DIMLINEAR】
相对标注		DAL 		【DA、DAL、DIMALIGNED】
角度标注		DAN		【DAN、DIMANGULAR】
箭头标注		LE		【LE、QLEADER】
半径标注		DRA		【DR、DRA、DIMRADIUS】
直径标注		DDI		【DDI、DIMDIAMETER】
折弯标注		DJO		【DJO、DIMJOGGED】
统计图块		TKTJB  
线图填充		XTA
弧长标注		DAR
连续标注		DCO
标高标注		BGBZ
剖切符号		PQFH		 
图名标注		TMBZ
箭头引注		JTYZ
索引符号		SYFH
引出标注		YCBZ
做法标注		ZFBZ
加折断线		JZDX 
绘制云线		HZYX 
画对称轴		HDCZ	
画指北针		HZBZ  
索引图名		SYTM
标注样式		D		【DIMSTYLE】
智能标注		ZNBZ		【DIM】
查找图形		CZTX

【文字命令】
多行文本		MT		【T、MT、MTEXT】
单行文本		TEXT
炸开文字		TXTEXP

【修改命令】
删除		E		【E、ERASE、Delete键】                         
移动		M		【M、MOVE】
缩放		SC		【SC、SCALE】
旋转		RO		【RO、ROTATE】
打散		X		【X、EXPLODE】
打断		BR		【BR、BREAK】
偏移		O 		【O、OFFSET】
镜像		MI		【MI、MIRROR】
阵列		AR		【AR、ARRAY】
环形阵列		HXZL
路径阵列		LJZL
 
测量长度		DL		【DIST】
测量面积		AA		【AA、AREA】
插入表格		TABLE 

图层		LA   		【LA、LAYER】
打开图层		DKTC
打开全部图层	QBDK
关闭图层		GBTC
关闭其他图层	GBQT
全部冻结		QBDJ
全部解冻		QBJD
全部锁定		QBSD
全部解锁		QBJS
颜色		COL		【COL、COLOR】

【其他命令】
刷新		F5		【RE、REGEN】
正交		F8
帮助		F1

外部参照		XREF
插入图块		I		【I、INSERT】
合并图块/定义块	BLOCK
合并多段线	PE
绘图次序		DRAWORDER
创建底图		CABG
拆图打印		CTDY

基点复制		CO		【BSC、BASECOPY】
带基点复制	COPYBASE	【CPB】（可跨图纸）
横向缩放		SCALEX		【SCX】
纵向缩放		SCALEY		【SCY】

定数等分		DIVIDE		【DIV】
定距等分		MEASURE	【ME】
关闭点样式	PDMODE（等分命令结束后可关闭点样式）

创建视口		MAKEVIEW	【MV】
退出视口		PSPACE
3D模型导出	3DME

开启快捷编辑按钮	KQVIEWK
关闭快捷编辑按钮	GBVIEWK

开启定量捕捉	KQDLBZ
关闭定量捕捉	GBDLBZ

视图切换：(建议不要在俯视图以外的视图中进行图纸编辑)
俯视图		3DTOP
仰视图		3DBTM

【小技巧】空格键重复上一个命令


2.常用CTRL快捷键  

【CTRL】＋N（新建文件）
【CTRL】＋O（打开文件）  
【CTRL】＋S（保存文件） 
【CTRL】＋A（全选）  
【CTRL】＋P（打印文件） 
【CTRL】＋Z（撤销）         
【CTRL】＋Y（恢复）
【CTRL】＋X（剪切） 
【CTRL】＋C（复制） 
【CTRL】＋【SHIFT】+C（带基点复制）
【CTRL】＋V（粘贴） 
【CTRL】＋D（删除） 
【CTRL】＋T（文字标注）
【CTRL】＋W（关闭一页）
【CTRL】＋L（正交）
【CTRL】＋'+'（放大）  
【CTRL】＋'-'（缩小）
【CTRL】＋【SHIFT】+S（另存为）
【CTRL】＋F（搜索框）


3.家装设计专业命令

【墙柱轴线】
绘制房间		HZFJ		【HZ、HZF、HZFJ】
绘制轴线		HZZX 		【HZZ、HZZX】
绘制轴网		HZZW		【HZZW】
轴线偏移		ZXPY		【ZX、ZXP、ZXPY】
绘制墙体		HZQT		【HZQ、HZQT】
绘制弧墙		HZHQ		【HZH、HZHQ】
绘制隔断		HZGD		【HZG、HZGD】
挖墙洞		WQD		【WQ、WQD】
打断墙体		DDQT		【DD、DDQ、DDQT】
插入柱子		CRZZ		【CR、CRZ、CRZZ】
矩形屋顶		JXWD
攒尖屋顶		ZJWD

【绘制门窗】
单开门		DKM		【DK、DKM】
单门翻转		DMFZ		【DM、DMF、DMFZ】
双开门		SKM		【SK、SKM】
推拉门		TLM		【TL、TLM】
阳台门		YTM		【Y、YT、YTM】
标准窗		BZC		【BZ、BZC】
飘窗		PC
转角窗		ZJC		【ZJ、ZJC】
转角飘窗		ZJPC		【ZJP、ZJPC】

【楼梯阳台】
绘制阳台		HZYT		【HZY、HZYT】
自定义阳台	ZDYYT		【Z、ZD、ZDY、ZDYY、ZDYYT】

【暖通盘管】
回字形盘管	HZPG
自由盘管		ZYPG
盘管倒角		PGDJ
盘管长度查询	PGCX  	******结果仅供参考

【电气灯光】
照明线		ZMX		【ZM、ZMX】
空调动力线	KTDLX		【K、KT、KTD、KTDL、KTDLX】
电话线		DHX		【DH、DHX】
电视线		DSX		【DSX】
网络线		WLX		【WL、WLX】
强电系统图	QDXTT	   	

【水管空调】
水管		SG
热水管		RSG		【RS、RSG】
煤气管		MQG		【MQ、MQG】
污水管		WSG		【WS、WSG】
空调冷凝水管	KTLNSG		【KTL、KTLN、KTLNS、KTLNSG】
排风管		PFG		【PF、PFG】
排烟风管		PYFG		【PY、PYF、PYFG】

【室内立面】
立面窗套		LMCT
立面屋顶		LMWD
双线楼板		SXLB
柱立面线		ZLMX

【剖面做法】
画剖面墙		HPMQ
剖面门窗		PMMC
剖面檐口		PMYK
加剖断梁		JPDL


4.园林设计命令

绘制道路		HZDL
道路圆角		DLYJ

任意布树		RYBS
画地被线		HDBX
地被填充		DBTC

面积标注		MJBZ
直线标注		ZXBZ
弧线标注		HXBZ

乔灌苗木统计表	QGMTJ
苗木图例表	MMTL
地被面积表	DBMJ


5.弱电设计命令

设备编号		SBBH

放置机柜		FZJG
绘制防护管线	FHGX
防护管线标注	FHGXBZ

绘制桥架		HZQJ
桥架标注		QJBZ
桥架打断		QJDD		【BREAK】
桥架合并		QJHB

星形系统图	XTT
虚线框		XXK
工程数量表	GCSLB
设备图例表	SBTL


